########################################
#......................................#
#..######..##########..##########..##..#
#..#....#..#........#..#........#..#...#
#..#....#..#........#..#........#..#...#
#..#....#..#........#..#........#..#...#
#..#....#..#........#..#........#..#...#
#..#....#..#........#..#........#..#...#
#..#....#..#........#..#........#..#...#
#..####.#..####..####..####..####..##..#
#.......#......#.......#..........#....#
#......................................#
#......................................#
#....##.........................##.....#
#....##.........................##.....#
#......................................#
#......................................#
#.......#......#.......#..........#....#
#..####.#..####..####..####..####..##..#
#..#....#..#........#..#........#..#...#
#..#....#..#........#..#........#..#...#
#..#....#..#........#..#........#..#...#
#..#....#..#........#..#........#..#...#
#..######..##########..##########..##..#
#......................................#
########################################