####################
#.............#....#
#.............#....#
#.......###...#....#
#.............#....#
#....######....#...#
#.............#....#
#.............#....#
###########........#
#..................#
#..................#
####################

