##########################################################################
#........................................................................#
#........R..............R..................R................R............#
#........................................................................#
##########################################################################
