########################################################################################
########################################################################################
########################################################################################
########################################################################################
########################################################################################
########################################################################################
##########.................................................#############################
##########.................................................#..........##################
##########....R....R....R....R....R....R....R....R....R....#..B.B.B.B.##################
##########.................................................#..B.B.B.B.##################
##########....R....R....R....R....R....R....R....R....R....#..B.B.B.B.##################
##########.................................................#..##########################
########################......................##############..........##################
########################......................##############................############
##########...............................................................#...###########
##########....$....B....B....B....B....B....B..............#........3.........##########
##########...............................................................#...###########
########################......................##############................############
########################......................##############..##########################
##########.................................................#..........##################
##########....R....R....R....R....R....R....R....R....R....#..B.B.B.B.##################
##########.................................................#..B.B.B.B.##################
##########....R....R....R....R....R....R....R....R....R....#..........##################
##########.................................................#############################
########################################################################################